         NO            ./sea.xpm

SO                     ./green.xpm

WE     ./gold.xpm

EA      ./silver.xpm

F 222,184,135

C 135,206,250


11111111111111111111
10000000000000000001
10000000000000000001
110000000N0000000001
11000000000000000001
10000000000000001101
11111111111111111111
