         NO            ./brown_stone.xpm

SO                     ./red_stone.xpm

WE     ./withe_stone.xpm

EA      ./gr_stone.xpm

F 222,184,135

C 135,206,250


1111111111111111111111111111
1000000000000000011000000001
10000000000000001 1000000001
110001000N000000111000000001
1100001000010000000000000001
1000000000000000110101001101
1111111111111111111111111111
