         NO            cub.h

SO                     cub.h

WE     cub.h

EA       cub.h

F 220,100,000

C 225,30,000


1111111111111111111111111111
100000011110000000000000001
1010001001110000000000000001
1001010000000000000001111111
1111111110110000011100011111
1000000000110000011101111111
1000000000000000000000000011111
10000000000N0000000000000000001
1100000000000000000000000000001
1000000000000000110000000001111
1000000000000000110101000001
1100000111010101111101110001
11110111 1110101 10111101001
11111111 1111111 11111111111
