         NO            cub.h

SO                     cub.h

WE     cub.h

EA       cub.h

F 220,100,000

C 225,30,000


11111111111111111111111111111111111111111111111111111111111111111111111111111111111111111111111111
10N00000111100000000000000000000000000000000000000000000000000000000000000000000000000000000000001
10100010011100000000000000000000000000000000000000000000000000000000000000000000000000000000000001
10010100000000000000011111111111111111111111111111111111111111111111111111111111111111111111111111
1111111110110000011100011111111
100000000011000001110111111111111
11110111111111011100000010001
11110111111111011101010010001
11000000110101011100000000001
10000000000000001100000000001
10000000000000001101010000001
1100000111010101111101110000111
11110111 1110101 101111010001
11111111 1111111 111111111111
